AttachAudioMixedProcessor = lib.AttachAudioMixedProcessor,
AttachAudioStreamProcessor = lib.AttachAudioStreamProcessor,
BeginBlendMode = lib.BeginBlendMode,
BeginDrawing = lib.BeginDrawing,
BeginMode2D = lib.BeginMode2D,
BeginMode3D = lib.BeginMode3D,
BeginScissorMode = lib.BeginScissorMode,
BeginShaderMode = lib.BeginShaderMode,
BeginTextureMode = lib.BeginTextureMode,
BeginVrStereoMode = lib.BeginVrStereoMode,
BuildPoseFromParentJoints = lib.BuildPoseFromParentJoints,
CameraMoveForward = lib.CameraMoveForward,
CameraMoveRight = lib.CameraMoveRight,
CameraMoveToTarget = lib.CameraMoveToTarget,
CameraMoveUp = lib.CameraMoveUp,
CameraPitch = lib.CameraPitch,
CameraRoll = lib.CameraRoll,
CameraYaw = lib.CameraYaw,
ChangeDirectory = lib.ChangeDirectory,
CharCallback = lib.CharCallback,
CheckCollisionBoxSphere = lib.CheckCollisionBoxSphere,
CheckCollisionBoxes = lib.CheckCollisionBoxes,
CheckCollisionCircleLine = lib.CheckCollisionCircleLine,
CheckCollisionCircleRec = lib.CheckCollisionCircleRec,
CheckCollisionCircles = lib.CheckCollisionCircles,
CheckCollisionLines = lib.CheckCollisionLines,
CheckCollisionPointCircle = lib.CheckCollisionPointCircle,
CheckCollisionPointLine = lib.CheckCollisionPointLine,
CheckCollisionPointPoly = lib.CheckCollisionPointPoly,
CheckCollisionPointRec = lib.CheckCollisionPointRec,
CheckCollisionPointTriangle = lib.CheckCollisionPointTriangle,
CheckCollisionRecs = lib.CheckCollisionRecs,
CheckCollisionSpheres = lib.CheckCollisionSpheres,
Clamp = lib.Clamp,
ClearBackground = lib.ClearBackground,
ClearWindowState = lib.ClearWindowState,
CloseAudioDevice = lib.CloseAudioDevice,
ClosePlatform = lib.ClosePlatform,
CloseWindow = lib.CloseWindow,
CodepointToUTF8 = lib.CodepointToUTF8,
ColorAlpha = lib.ColorAlpha,
ColorAlphaBlend = lib.ColorAlphaBlend,
ColorBrightness = lib.ColorBrightness,
ColorContrast = lib.ColorContrast,
ColorFromHSV = lib.ColorFromHSV,
ColorFromNormalized = lib.ColorFromNormalized,
ColorIsEqual = lib.ColorIsEqual,
ColorLerp = lib.ColorLerp,
ColorNormalize = lib.ColorNormalize,
ColorTint = lib.ColorTint,
ColorToHSV = lib.ColorToHSV,
ColorToInt = lib.ColorToInt,
CompressData = lib.CompressData,
ComputeCRC32 = lib.ComputeCRC32,
ComputeMD5 = lib.ComputeMD5,
ComputeSHA1 = lib.ComputeSHA1,
CursorEnterCallback = lib.CursorEnterCallback,
DecodeDataBase64 = lib.DecodeDataBase64,
DecompressData = lib.DecompressData,
DetachAudioMixedProcessor = lib.DetachAudioMixedProcessor,
DetachAudioStreamProcessor = lib.DetachAudioStreamProcessor,
DirectoryExists = lib.DirectoryExists,
DisableCursor = lib.DisableCursor,
DisableEventWaiting = lib.DisableEventWaiting,
DrawBillboard = lib.DrawBillboard,
DrawBillboardPro = lib.DrawBillboardPro,
DrawBillboardRec = lib.DrawBillboardRec,
DrawBoundingBox = lib.DrawBoundingBox,
DrawCapsule = lib.DrawCapsule,
DrawCapsuleWires = lib.DrawCapsuleWires,
DrawCircle = lib.DrawCircle,
DrawCircle3D = lib.DrawCircle3D,
DrawCircleGradient = lib.DrawCircleGradient,
DrawCircleLines = lib.DrawCircleLines,
DrawCircleLinesV = lib.DrawCircleLinesV,
DrawCircleSector = lib.DrawCircleSector,
DrawCircleSectorLines = lib.DrawCircleSectorLines,
DrawCircleV = lib.DrawCircleV,
DrawCube = lib.DrawCube,
DrawCubeV = lib.DrawCubeV,
DrawCubeWires = lib.DrawCubeWires,
DrawCubeWiresV = lib.DrawCubeWiresV,
DrawCylinder = lib.DrawCylinder,
DrawCylinderEx = lib.DrawCylinderEx,
DrawCylinderWires = lib.DrawCylinderWires,
DrawCylinderWiresEx = lib.DrawCylinderWiresEx,
DrawEllipse = lib.DrawEllipse,
DrawEllipseLines = lib.DrawEllipseLines,
DrawFPS = lib.DrawFPS,
DrawGrid = lib.DrawGrid,
DrawLine = lib.DrawLine,
DrawLine3D = lib.DrawLine3D,
DrawLineBezier = lib.DrawLineBezier,
DrawLineEx = lib.DrawLineEx,
DrawLineStrip = lib.DrawLineStrip,
DrawLineV = lib.DrawLineV,
DrawMesh = lib.DrawMesh,
DrawMeshInstanced = lib.DrawMeshInstanced,
DrawModel = lib.DrawModel,
DrawModelEx = lib.DrawModelEx,
DrawModelPoints = lib.DrawModelPoints,
DrawModelPointsEx = lib.DrawModelPointsEx,
DrawModelWires = lib.DrawModelWires,
DrawModelWiresEx = lib.DrawModelWiresEx,
DrawPixel = lib.DrawPixel,
DrawPixelV = lib.DrawPixelV,
DrawPlane = lib.DrawPlane,
DrawPoint3D = lib.DrawPoint3D,
DrawPoly = lib.DrawPoly,
DrawPolyLines = lib.DrawPolyLines,
DrawPolyLinesEx = lib.DrawPolyLinesEx,
DrawRay = lib.DrawRay,
DrawRectangle = lib.DrawRectangle,
DrawRectangleGradientEx = lib.DrawRectangleGradientEx,
DrawRectangleGradientH = lib.DrawRectangleGradientH,
DrawRectangleGradientV = lib.DrawRectangleGradientV,
DrawRectangleLines = lib.DrawRectangleLines,
DrawRectangleLinesEx = lib.DrawRectangleLinesEx,
DrawRectanglePro = lib.DrawRectanglePro,
DrawRectangleRec = lib.DrawRectangleRec,
DrawRectangleRounded = lib.DrawRectangleRounded,
DrawRectangleRoundedLines = lib.DrawRectangleRoundedLines,
DrawRectangleRoundedLinesEx = lib.DrawRectangleRoundedLinesEx,
DrawRectangleV = lib.DrawRectangleV,
DrawRing = lib.DrawRing,
DrawRingLines = lib.DrawRingLines,
DrawSphere = lib.DrawSphere,
DrawSphereEx = lib.DrawSphereEx,
DrawSphereWires = lib.DrawSphereWires,
DrawSplineBasis = lib.DrawSplineBasis,
DrawSplineBezierCubic = lib.DrawSplineBezierCubic,
DrawSplineBezierQuadratic = lib.DrawSplineBezierQuadratic,
DrawSplineCatmullRom = lib.DrawSplineCatmullRom,
DrawSplineLinear = lib.DrawSplineLinear,
DrawSplineSegmentBasis = lib.DrawSplineSegmentBasis,
DrawSplineSegmentBezierCubic = lib.DrawSplineSegmentBezierCubic,
DrawSplineSegmentBezierQuadratic = lib.DrawSplineSegmentBezierQuadratic,
DrawSplineSegmentCatmullRom = lib.DrawSplineSegmentCatmullRom,
DrawSplineSegmentLinear = lib.DrawSplineSegmentLinear,
DrawText = lib.DrawText,
DrawTextCodepoint = lib.DrawTextCodepoint,
DrawTextCodepoints = lib.DrawTextCodepoints,
DrawTextEx = lib.DrawTextEx,
DrawTextPro = lib.DrawTextPro,
DrawTexture = lib.DrawTexture,
DrawTextureEx = lib.DrawTextureEx,
DrawTextureNPatch = lib.DrawTextureNPatch,
DrawTexturePro = lib.DrawTexturePro,
DrawTextureRec = lib.DrawTextureRec,
DrawTextureV = lib.DrawTextureV,
DrawTriangle = lib.DrawTriangle,
DrawTriangle3D = lib.DrawTriangle3D,
DrawTriangleFan = lib.DrawTriangleFan,
DrawTriangleLines = lib.DrawTriangleLines,
DrawTriangleStrip = lib.DrawTriangleStrip,
DrawTriangleStrip3D = lib.DrawTriangleStrip3D,
EnableCursor = lib.EnableCursor,
EnableEventWaiting = lib.EnableEventWaiting,
EncodeDataBase64 = lib.EncodeDataBase64,
EndBlendMode = lib.EndBlendMode,
EndDrawing = lib.EndDrawing,
EndMode2D = lib.EndMode2D,
EndMode3D = lib.EndMode3D,
EndScissorMode = lib.EndScissorMode,
EndShaderMode = lib.EndShaderMode,
EndTextureMode = lib.EndTextureMode,
EndVrStereoMode = lib.EndVrStereoMode,
ErrorCallback = lib.ErrorCallback,
ExportAutomationEventList = lib.ExportAutomationEventList,
ExportDataAsCode = lib.ExportDataAsCode,
ExportFontAsCode = lib.ExportFontAsCode,
ExportImage = lib.ExportImage,
ExportImageAsCode = lib.ExportImageAsCode,
ExportImageToMemory = lib.ExportImageToMemory,
ExportMesh = lib.ExportMesh,
ExportMeshAsCode = lib.ExportMeshAsCode,
ExportWave = lib.ExportWave,
ExportWaveAsCode = lib.ExportWaveAsCode,
Fade = lib.Fade,
FileExists = lib.FileExists,
FloatEquals = lib.FloatEquals,
FloatToHalf = lib.FloatToHalf,
GenImageCellular = lib.GenImageCellular,
GenImageChecked = lib.GenImageChecked,
GenImageColor = lib.GenImageColor,
GenImageFontAtlas = lib.GenImageFontAtlas,
GenImageGradientLinear = lib.GenImageGradientLinear,
GenImageGradientRadial = lib.GenImageGradientRadial,
GenImageGradientSquare = lib.GenImageGradientSquare,
GenImagePerlinNoise = lib.GenImagePerlinNoise,
GenImageText = lib.GenImageText,
GenImageWhiteNoise = lib.GenImageWhiteNoise,
GenMeshCone = lib.GenMeshCone,
GenMeshCube = lib.GenMeshCube,
GenMeshCubicmap = lib.GenMeshCubicmap,
GenMeshCylinder = lib.GenMeshCylinder,
GenMeshHeightmap = lib.GenMeshHeightmap,
GenMeshHemiSphere = lib.GenMeshHemiSphere,
GenMeshKnot = lib.GenMeshKnot,
GenMeshPlane = lib.GenMeshPlane,
GenMeshPoly = lib.GenMeshPoly,
GenMeshSphere = lib.GenMeshSphere,
GenMeshTangents = lib.GenMeshTangents,
GenMeshTorus = lib.GenMeshTorus,
GenTextureMipmaps = lib.GenTextureMipmaps,
GetApplicationDirectory = lib.GetApplicationDirectory,
GetCameraForward = lib.GetCameraForward,
GetCameraMatrix = lib.GetCameraMatrix,
GetCameraMatrix2D = lib.GetCameraMatrix2D,
GetCameraProjectionMatrix = lib.GetCameraProjectionMatrix,
GetCameraRight = lib.GetCameraRight,
GetCameraUp = lib.GetCameraUp,
GetCameraViewMatrix = lib.GetCameraViewMatrix,
GetCharPressed = lib.GetCharPressed,
GetClipboardImage = lib.GetClipboardImage,
GetClipboardText = lib.GetClipboardText,
GetCodepoint = lib.GetCodepoint,
GetCodepointCount = lib.GetCodepointCount,
GetCodepointNext = lib.GetCodepointNext,
GetCodepointPrevious = lib.GetCodepointPrevious,
GetCollisionRec = lib.GetCollisionRec,
GetColor = lib.GetColor,
GetCurrentMonitor = lib.GetCurrentMonitor,
GetDirectoryPath = lib.GetDirectoryPath,
GetFPS = lib.GetFPS,
GetFileExtension = lib.GetFileExtension,
GetFileLength = lib.GetFileLength,
GetFileModTime = lib.GetFileModTime,
GetFileName = lib.GetFileName,
GetFileNameWithoutExt = lib.GetFileNameWithoutExt,
GetFontDefault = lib.GetFontDefault,
GetFrameTime = lib.GetFrameTime,
GetGamepadAxisCount = lib.GetGamepadAxisCount,
GetGamepadAxisMovement = lib.GetGamepadAxisMovement,
GetGamepadButtonPressed = lib.GetGamepadButtonPressed,
GetGamepadName = lib.GetGamepadName,
GetGestureDetected = lib.GetGestureDetected,
GetGestureDragAngle = lib.GetGestureDragAngle,
GetGestureDragVector = lib.GetGestureDragVector,
GetGestureHoldDuration = lib.GetGestureHoldDuration,
GetGesturePinchAngle = lib.GetGesturePinchAngle,
GetGesturePinchVector = lib.GetGesturePinchVector,
GetGlyphAtlasRec = lib.GetGlyphAtlasRec,
GetGlyphIndex = lib.GetGlyphIndex,
GetGlyphInfo = lib.GetGlyphInfo,
GetImageAlphaBorder = lib.GetImageAlphaBorder,
GetImageColor = lib.GetImageColor,
GetKeyName = lib.GetKeyName,
GetKeyPressed = lib.GetKeyPressed,
GetLine = lib.GetLine,
GetMasterVolume = lib.GetMasterVolume,
GetMeshBoundingBox = lib.GetMeshBoundingBox,
GetModelBoundingBox = lib.GetModelBoundingBox,
GetMonitorCount = lib.GetMonitorCount,
GetMonitorHeight = lib.GetMonitorHeight,
GetMonitorName = lib.GetMonitorName,
GetMonitorPhysicalHeight = lib.GetMonitorPhysicalHeight,
GetMonitorPhysicalWidth = lib.GetMonitorPhysicalWidth,
GetMonitorPosition = lib.GetMonitorPosition,
GetMonitorRefreshRate = lib.GetMonitorRefreshRate,
GetMonitorWidth = lib.GetMonitorWidth,
GetMouseDelta = lib.GetMouseDelta,
GetMousePosition = lib.GetMousePosition,
GetMouseWheelMove = lib.GetMouseWheelMove,
GetMouseWheelMoveV = lib.GetMouseWheelMoveV,
GetMouseX = lib.GetMouseX,
GetMouseY = lib.GetMouseY,
GetMusicTimeLength = lib.GetMusicTimeLength,
GetMusicTimePlayed = lib.GetMusicTimePlayed,
GetPixelColor = lib.GetPixelColor,
GetPixelDataSize = lib.GetPixelDataSize,
GetPoseAtTimeGLTF = lib.GetPoseAtTimeGLTF,
GetPrevDirectoryPath = lib.GetPrevDirectoryPath,
GetRandomValue = lib.GetRandomValue,
GetRayCollisionBox = lib.GetRayCollisionBox,
GetRayCollisionMesh = lib.GetRayCollisionMesh,
GetRayCollisionQuad = lib.GetRayCollisionQuad,
GetRayCollisionSphere = lib.GetRayCollisionSphere,
GetRayCollisionTriangle = lib.GetRayCollisionTriangle,
GetRenderHeight = lib.GetRenderHeight,
GetRenderWidth = lib.GetRenderWidth,
GetScreenHeight = lib.GetScreenHeight,
GetScreenToWorld2D = lib.GetScreenToWorld2D,
GetScreenToWorldRay = lib.GetScreenToWorldRay,
GetScreenToWorldRayEx = lib.GetScreenToWorldRayEx,
GetScreenWidth = lib.GetScreenWidth,
GetShaderLocation = lib.GetShaderLocation,
GetShaderLocationAttrib = lib.GetShaderLocationAttrib,
GetShapesTexture = lib.GetShapesTexture,
GetShapesTextureRectangle = lib.GetShapesTextureRectangle,
GetSplinePointBasis = lib.GetSplinePointBasis,
GetSplinePointBezierCubic = lib.GetSplinePointBezierCubic,
GetSplinePointBezierQuad = lib.GetSplinePointBezierQuad,
GetSplinePointCatmullRom = lib.GetSplinePointCatmullRom,
GetSplinePointLinear = lib.GetSplinePointLinear,
GetTime = lib.GetTime,
GetTouchPointCount = lib.GetTouchPointCount,
GetTouchPointId = lib.GetTouchPointId,
GetTouchPosition = lib.GetTouchPosition,
GetTouchX = lib.GetTouchX,
GetTouchY = lib.GetTouchY,
GetWindowHandle = lib.GetWindowHandle,
GetWindowPosition = lib.GetWindowPosition,
GetWindowScaleDPI = lib.GetWindowScaleDPI,
GetWorkingDirectory = lib.GetWorkingDirectory,
GetWorldToScreen = lib.GetWorldToScreen,
GetWorldToScreen2D = lib.GetWorldToScreen2D,
GetWorldToScreenEx = lib.GetWorldToScreenEx,
HalfToFloat = lib.HalfToFloat,
HideCursor = lib.HideCursor,
ImageAlphaClear = lib.ImageAlphaClear,
ImageAlphaCrop = lib.ImageAlphaCrop,
ImageAlphaMask = lib.ImageAlphaMask,
ImageAlphaPremultiply = lib.ImageAlphaPremultiply,
ImageBlurGaussian = lib.ImageBlurGaussian,
ImageClearBackground = lib.ImageClearBackground,
ImageColorBrightness = lib.ImageColorBrightness,
ImageColorContrast = lib.ImageColorContrast,
ImageColorGrayscale = lib.ImageColorGrayscale,
ImageColorInvert = lib.ImageColorInvert,
ImageColorReplace = lib.ImageColorReplace,
ImageColorTint = lib.ImageColorTint,
ImageCopy = lib.ImageCopy,
ImageCrop = lib.ImageCrop,
ImageDither = lib.ImageDither,
ImageDraw = lib.ImageDraw,
ImageDrawCircle = lib.ImageDrawCircle,
ImageDrawCircleLines = lib.ImageDrawCircleLines,
ImageDrawCircleLinesV = lib.ImageDrawCircleLinesV,
ImageDrawCircleV = lib.ImageDrawCircleV,
ImageDrawLine = lib.ImageDrawLine,
ImageDrawLineEx = lib.ImageDrawLineEx,
ImageDrawLineV = lib.ImageDrawLineV,
ImageDrawPixel = lib.ImageDrawPixel,
ImageDrawPixelV = lib.ImageDrawPixelV,
ImageDrawRectangle = lib.ImageDrawRectangle,
ImageDrawRectangleLines = lib.ImageDrawRectangleLines,
ImageDrawRectangleRec = lib.ImageDrawRectangleRec,
ImageDrawRectangleV = lib.ImageDrawRectangleV,
ImageDrawText = lib.ImageDrawText,
ImageDrawTextEx = lib.ImageDrawTextEx,
ImageDrawTriangle = lib.ImageDrawTriangle,
ImageDrawTriangleEx = lib.ImageDrawTriangleEx,
ImageDrawTriangleFan = lib.ImageDrawTriangleFan,
ImageDrawTriangleLines = lib.ImageDrawTriangleLines,
ImageDrawTriangleStrip = lib.ImageDrawTriangleStrip,
ImageFlipHorizontal = lib.ImageFlipHorizontal,
ImageFlipVertical = lib.ImageFlipVertical,
ImageFormat = lib.ImageFormat,
ImageFromChannel = lib.ImageFromChannel,
ImageFromImage = lib.ImageFromImage,
ImageKernelConvolution = lib.ImageKernelConvolution,
ImageMipmaps = lib.ImageMipmaps,
ImageResize = lib.ImageResize,
ImageResizeCanvas = lib.ImageResizeCanvas,
ImageResizeNN = lib.ImageResizeNN,
ImageRotate = lib.ImageRotate,
ImageRotateCCW = lib.ImageRotateCCW,
ImageRotateCW = lib.ImageRotateCW,
ImageText = lib.ImageText,
ImageTextEx = lib.ImageTextEx,
ImageToPOT = lib.ImageToPOT,
InitAudioDevice = lib.InitAudioDevice,
InitPlatform = lib.InitPlatform,
InitWindow = lib.InitWindow,
IsAudioBufferPlaying = lib.IsAudioBufferPlaying,
IsAudioDeviceReady = lib.IsAudioDeviceReady,
IsAudioStreamPlaying = lib.IsAudioStreamPlaying,
IsAudioStreamProcessed = lib.IsAudioStreamProcessed,
IsAudioStreamValid = lib.IsAudioStreamValid,
IsCursorHidden = lib.IsCursorHidden,
IsCursorOnScreen = lib.IsCursorOnScreen,
IsFileDropped = lib.IsFileDropped,
IsFileExtension = lib.IsFileExtension,
IsFileNameValid = lib.IsFileNameValid,
IsFontValid = lib.IsFontValid,
IsGamepadAvailable = lib.IsGamepadAvailable,
IsGamepadButtonDown = lib.IsGamepadButtonDown,
IsGamepadButtonPressed = lib.IsGamepadButtonPressed,
IsGamepadButtonReleased = lib.IsGamepadButtonReleased,
IsGamepadButtonUp = lib.IsGamepadButtonUp,
IsGestureDetected = lib.IsGestureDetected,
IsImageValid = lib.IsImageValid,
IsKeyDown = lib.IsKeyDown,
IsKeyPressed = lib.IsKeyPressed,
IsKeyPressedRepeat = lib.IsKeyPressedRepeat,
IsKeyReleased = lib.IsKeyReleased,
IsKeyUp = lib.IsKeyUp,
IsMaterialValid = lib.IsMaterialValid,
IsModelAnimationValid = lib.IsModelAnimationValid,
IsModelValid = lib.IsModelValid,
IsMouseButtonDown = lib.IsMouseButtonDown,
IsMouseButtonPressed = lib.IsMouseButtonPressed,
IsMouseButtonReleased = lib.IsMouseButtonReleased,
IsMouseButtonUp = lib.IsMouseButtonUp,
IsMusicStreamPlaying = lib.IsMusicStreamPlaying,
IsMusicValid = lib.IsMusicValid,
IsPathFile = lib.IsPathFile,
IsRenderTextureValid = lib.IsRenderTextureValid,
IsShaderValid = lib.IsShaderValid,
IsSoundPlaying = lib.IsSoundPlaying,
IsSoundValid = lib.IsSoundValid,
IsTextureValid = lib.IsTextureValid,
IsWaveValid = lib.IsWaveValid,
IsWindowFocused = lib.IsWindowFocused,
IsWindowFullscreen = lib.IsWindowFullscreen,
IsWindowHidden = lib.IsWindowHidden,
IsWindowMaximized = lib.IsWindowMaximized,
IsWindowMinimized = lib.IsWindowMinimized,
IsWindowReady = lib.IsWindowReady,
IsWindowResized = lib.IsWindowResized,
IsWindowState = lib.IsWindowState,
JoystickCallback = lib.JoystickCallback,
KeyCallback = lib.KeyCallback,
Lerp = lib.Lerp,
LoadAudioBuffer = lib.LoadAudioBuffer,
LoadAudioStream = lib.LoadAudioStream,
LoadAutomationEventList = lib.LoadAutomationEventList,
LoadBMFont = lib.LoadBMFont,
LoadBoneInfoGLTF = lib.LoadBoneInfoGLTF,
LoadCodepoints = lib.LoadCodepoints,
LoadDirectoryFiles = lib.LoadDirectoryFiles,
LoadDirectoryFilesEx = lib.LoadDirectoryFilesEx,
LoadDroppedFiles = lib.LoadDroppedFiles,
LoadFileData = lib.LoadFileData,
LoadFileGLTFCallback = lib.LoadFileGLTFCallback,
LoadFileText = lib.LoadFileText,
LoadFont = lib.LoadFont,
LoadFontData = lib.LoadFontData,
LoadFontDefault = lib.LoadFontDefault,
LoadFontEx = lib.LoadFontEx,
LoadFontFromImage = lib.LoadFontFromImage,
LoadFontFromMemory = lib.LoadFontFromMemory,
LoadIQM = lib.LoadIQM,
LoadImage = lib.LoadImage,
LoadImageAnim = lib.LoadImageAnim,
LoadImageAnimFromMemory = lib.LoadImageAnimFromMemory,
LoadImageColors = lib.LoadImageColors,
LoadImageFromCgltfImage = lib.LoadImageFromCgltfImage,
LoadImageFromMemory = lib.LoadImageFromMemory,
LoadImageFromScreen = lib.LoadImageFromScreen,
LoadImageFromTexture = lib.LoadImageFromTexture,
LoadImagePalette = lib.LoadImagePalette,
LoadImageRaw = lib.LoadImageRaw,
LoadMaterialDefault = lib.LoadMaterialDefault,
LoadMaterials = lib.LoadMaterials,
LoadModel = lib.LoadModel,
LoadModelAnimations = lib.LoadModelAnimations,
LoadModelFromMesh = lib.LoadModelFromMesh,
LoadMusicStream = lib.LoadMusicStream,
LoadMusicStreamFromMemory = lib.LoadMusicStreamFromMemory,
LoadOBJ = lib.LoadOBJ,
LoadRandomSequence = lib.LoadRandomSequence,
LoadRenderTexture = lib.LoadRenderTexture,
LoadShader = lib.LoadShader,
LoadShaderFromMemory = lib.LoadShaderFromMemory,
LoadSound = lib.LoadSound,
LoadSoundAlias = lib.LoadSoundAlias,
LoadSoundFromWave = lib.LoadSoundFromWave,
LoadTexture = lib.LoadTexture,
LoadTextureCubemap = lib.LoadTextureCubemap,
LoadTextureFromImage = lib.LoadTextureFromImage,
LoadUTF8 = lib.LoadUTF8,
LoadVrStereoConfig = lib.LoadVrStereoConfig,
LoadWave = lib.LoadWave,
LoadWaveFromMemory = lib.LoadWaveFromMemory,
LoadWaveSamples = lib.LoadWaveSamples,
MakeDirectory = lib.MakeDirectory,
MatrixAdd = lib.MatrixAdd,
MatrixDecompose = lib.MatrixDecompose,
MatrixDeterminant = lib.MatrixDeterminant,
MatrixFrustum = lib.MatrixFrustum,
MatrixIdentity = lib.MatrixIdentity,
MatrixInvert = lib.MatrixInvert,
MatrixLookAt = lib.MatrixLookAt,
MatrixMultiply = lib.MatrixMultiply,
MatrixOrtho = lib.MatrixOrtho,
MatrixPerspective = lib.MatrixPerspective,
MatrixRotate = lib.MatrixRotate,
MatrixRotateX = lib.MatrixRotateX,
MatrixRotateXYZ = lib.MatrixRotateXYZ,
MatrixRotateY = lib.MatrixRotateY,
MatrixRotateZ = lib.MatrixRotateZ,
MatrixRotateZYX = lib.MatrixRotateZYX,
MatrixScale = lib.MatrixScale,
MatrixSubtract = lib.MatrixSubtract,
MatrixToFloatV = lib.MatrixToFloatV,
MatrixTrace = lib.MatrixTrace,
MatrixTranslate = lib.MatrixTranslate,
MatrixTranspose = lib.MatrixTranspose,
MaximizeWindow = lib.MaximizeWindow,
MeasureText = lib.MeasureText,
MeasureTextEx = lib.MeasureTextEx,
MemAlloc = lib.MemAlloc,
MemFree = lib.MemFree,
MemRealloc = lib.MemRealloc,
MinimizeWindow = lib.MinimizeWindow,
MouseButtonCallback = lib.MouseButtonCallback,
MouseCursorPosCallback = lib.MouseCursorPosCallback,
MouseScrollCallback = lib.MouseScrollCallback,
Normalize = lib.Normalize,
OnSendAudioDataToDevice = lib.OnSendAudioDataToDevice,
OpenURL = lib.OpenURL,
PauseAudioBuffer = lib.PauseAudioBuffer,
PauseAudioStream = lib.PauseAudioStream,
PauseMusicStream = lib.PauseMusicStream,
PauseSound = lib.PauseSound,
PlayAudioBuffer = lib.PlayAudioBuffer,
PlayAudioStream = lib.PlayAudioStream,
PlayAutomationEvent = lib.PlayAutomationEvent,
PlayMusicStream = lib.PlayMusicStream,
PlaySound = lib.PlaySound,
PollInputEvents = lib.PollInputEvents,
ProcessGestureEvent = lib.ProcessGestureEvent,
ProcessMaterialsOBJ = lib.ProcessMaterialsOBJ,
QuaternionAdd = lib.QuaternionAdd,
QuaternionAddValue = lib.QuaternionAddValue,
QuaternionCubicHermiteSpline = lib.QuaternionCubicHermiteSpline,
QuaternionDivide = lib.QuaternionDivide,
QuaternionEquals = lib.QuaternionEquals,
QuaternionFromAxisAngle = lib.QuaternionFromAxisAngle,
QuaternionFromEuler = lib.QuaternionFromEuler,
QuaternionFromMatrix = lib.QuaternionFromMatrix,
QuaternionFromVector3ToVector3 = lib.QuaternionFromVector3ToVector3,
QuaternionIdentity = lib.QuaternionIdentity,
QuaternionInvert = lib.QuaternionInvert,
QuaternionLength = lib.QuaternionLength,
QuaternionLerp = lib.QuaternionLerp,
QuaternionMultiply = lib.QuaternionMultiply,
QuaternionNlerp = lib.QuaternionNlerp,
QuaternionNormalize = lib.QuaternionNormalize,
QuaternionScale = lib.QuaternionScale,
QuaternionSlerp = lib.QuaternionSlerp,
QuaternionSubtract = lib.QuaternionSubtract,
QuaternionSubtractValue = lib.QuaternionSubtractValue,
QuaternionToAxisAngle = lib.QuaternionToAxisAngle,
QuaternionToEuler = lib.QuaternionToEuler,
QuaternionToMatrix = lib.QuaternionToMatrix,
QuaternionTransform = lib.QuaternionTransform,
ReleaseFileGLTFCallback = lib.ReleaseFileGLTFCallback,
Remap = lib.Remap,
RestoreWindow = lib.RestoreWindow,
ResumeAudioBuffer = lib.ResumeAudioBuffer,
ResumeAudioStream = lib.ResumeAudioStream,
ResumeMusicStream = lib.ResumeMusicStream,
ResumeSound = lib.ResumeSound,
SaveFileData = lib.SaveFileData,
SaveFileText = lib.SaveFileText,
ScanDirectoryFiles = lib.ScanDirectoryFiles,
ScanDirectoryFilesRecursively = lib.ScanDirectoryFilesRecursively,
SeekMusicStream = lib.SeekMusicStream,
SetAudioBufferPan = lib.SetAudioBufferPan,
SetAudioBufferPitch = lib.SetAudioBufferPitch,
SetAudioBufferVolume = lib.SetAudioBufferVolume,
SetAudioStreamBufferSizeDefault = lib.SetAudioStreamBufferSizeDefault,
SetAudioStreamCallback = lib.SetAudioStreamCallback,
SetAudioStreamPan = lib.SetAudioStreamPan,
SetAudioStreamPitch = lib.SetAudioStreamPitch,
SetAudioStreamVolume = lib.SetAudioStreamVolume,
SetAutomationEventBaseFrame = lib.SetAutomationEventBaseFrame,
SetAutomationEventList = lib.SetAutomationEventList,
SetClipboardText = lib.SetClipboardText,
SetConfigFlags = lib.SetConfigFlags,
SetDimensionsFromMonitor = lib.SetDimensionsFromMonitor,
SetExitKey = lib.SetExitKey,
SetGamepadMappings = lib.SetGamepadMappings,
SetGamepadVibration = lib.SetGamepadVibration,
SetGesturesEnabled = lib.SetGesturesEnabled,
SetLoadFileDataCallback = lib.SetLoadFileDataCallback,
SetLoadFileTextCallback = lib.SetLoadFileTextCallback,
SetMasterVolume = lib.SetMasterVolume,
SetMaterialTexture = lib.SetMaterialTexture,
SetModelMeshMaterial = lib.SetModelMeshMaterial,
SetMouseCursor = lib.SetMouseCursor,
SetMouseOffset = lib.SetMouseOffset,
SetMousePosition = lib.SetMousePosition,
SetMouseScale = lib.SetMouseScale,
SetMusicPan = lib.SetMusicPan,
SetMusicPitch = lib.SetMusicPitch,
SetMusicVolume = lib.SetMusicVolume,
SetPixelColor = lib.SetPixelColor,
SetRandomSeed = lib.SetRandomSeed,
SetSaveFileDataCallback = lib.SetSaveFileDataCallback,
SetSaveFileTextCallback = lib.SetSaveFileTextCallback,
SetShaderValue = lib.SetShaderValue,
SetShaderValueMatrix = lib.SetShaderValueMatrix,
SetShaderValueTexture = lib.SetShaderValueTexture,
SetShaderValueV = lib.SetShaderValueV,
SetShapesTexture = lib.SetShapesTexture,
SetSoundPan = lib.SetSoundPan,
SetSoundPitch = lib.SetSoundPitch,
SetSoundVolume = lib.SetSoundVolume,
SetTargetFPS = lib.SetTargetFPS,
SetTextLineSpacing = lib.SetTextLineSpacing,
SetTextureFilter = lib.SetTextureFilter,
SetTextureWrap = lib.SetTextureWrap,
SetTraceLogCallback = lib.SetTraceLogCallback,
SetTraceLogLevel = lib.SetTraceLogLevel,
SetWindowFocused = lib.SetWindowFocused,
SetWindowIcon = lib.SetWindowIcon,
SetWindowIcons = lib.SetWindowIcons,
SetWindowMaxSize = lib.SetWindowMaxSize,
SetWindowMinSize = lib.SetWindowMinSize,
SetWindowMonitor = lib.SetWindowMonitor,
SetWindowOpacity = lib.SetWindowOpacity,
SetWindowPosition = lib.SetWindowPosition,
SetWindowSize = lib.SetWindowSize,
SetWindowState = lib.SetWindowState,
SetWindowTitle = lib.SetWindowTitle,
SetupViewport = lib.SetupViewport,
ShowCursor = lib.ShowCursor,
StartAutomationEventRecording = lib.StartAutomationEventRecording,
StopAudioBuffer = lib.StopAudioBuffer,
StopAudioBufferInLockedState = lib.StopAudioBufferInLockedState,
StopAudioStream = lib.StopAudioStream,
StopAutomationEventRecording = lib.StopAutomationEventRecording,
StopMusicStream = lib.StopMusicStream,
StopSound = lib.StopSound,
SwapScreenBuffer = lib.SwapScreenBuffer,
TakeScreenshot = lib.TakeScreenshot,
TextAppend = lib.TextAppend,
TextCopy = lib.TextCopy,
TextFindIndex = lib.TextFindIndex,
TextFormat = lib.TextFormat,
TextInsert = lib.TextInsert,
TextIsEqual = lib.TextIsEqual,
TextJoin = lib.TextJoin,
TextLength = lib.TextLength,
TextReplace = lib.TextReplace,
TextSplit = lib.TextSplit,
TextSubtext = lib.TextSubtext,
TextToCamel = lib.TextToCamel,
TextToFloat = lib.TextToFloat,
TextToInteger = lib.TextToInteger,
TextToLower = lib.TextToLower,
TextToPascal = lib.TextToPascal,
TextToSnake = lib.TextToSnake,
TextToUpper = lib.TextToUpper,
ToggleBorderlessWindowed = lib.ToggleBorderlessWindowed,
ToggleFullscreen = lib.ToggleFullscreen,
TraceLog = lib.TraceLog,
TrackAudioBuffer = lib.TrackAudioBuffer,
UnloadAudioBuffer = lib.UnloadAudioBuffer,
UnloadAudioStream = lib.UnloadAudioStream,
UnloadAutomationEventList = lib.UnloadAutomationEventList,
UnloadCodepoints = lib.UnloadCodepoints,
UnloadDirectoryFiles = lib.UnloadDirectoryFiles,
UnloadDroppedFiles = lib.UnloadDroppedFiles,
UnloadFileData = lib.UnloadFileData,
UnloadFileText = lib.UnloadFileText,
UnloadFont = lib.UnloadFont,
UnloadFontData = lib.UnloadFontData,
UnloadFontDefault = lib.UnloadFontDefault,
UnloadImage = lib.UnloadImage,
UnloadImageColors = lib.UnloadImageColors,
UnloadImagePalette = lib.UnloadImagePalette,
UnloadMaterial = lib.UnloadMaterial,
UnloadMesh = lib.UnloadMesh,
UnloadModel = lib.UnloadModel,
UnloadModelAnimation = lib.UnloadModelAnimation,
UnloadModelAnimations = lib.UnloadModelAnimations,
UnloadMusicStream = lib.UnloadMusicStream,
UnloadRandomSequence = lib.UnloadRandomSequence,
UnloadRenderTexture = lib.UnloadRenderTexture,
UnloadShader = lib.UnloadShader,
UnloadSound = lib.UnloadSound,
UnloadSoundAlias = lib.UnloadSoundAlias,
UnloadTexture = lib.UnloadTexture,
UnloadUTF8 = lib.UnloadUTF8,
UnloadVrStereoConfig = lib.UnloadVrStereoConfig,
UnloadWave = lib.UnloadWave,
UnloadWaveSamples = lib.UnloadWaveSamples,
UntrackAudioBuffer = lib.UntrackAudioBuffer,
UpdateAudioStream = lib.UpdateAudioStream,
UpdateAudioStreamInLockedState = lib.UpdateAudioStreamInLockedState,
UpdateCamera = lib.UpdateCamera,
UpdateCameraPro = lib.UpdateCameraPro,
UpdateGestures = lib.UpdateGestures,
UpdateMeshBuffer = lib.UpdateMeshBuffer,
UpdateModelAnimation = lib.UpdateModelAnimation,
UpdateModelAnimationBones = lib.UpdateModelAnimationBones,
UpdateMusicStream = lib.UpdateMusicStream,
UpdateSound = lib.UpdateSound,
UpdateTexture = lib.UpdateTexture,
UpdateTextureRec = lib.UpdateTextureRec,
UploadMesh = lib.UploadMesh,
Vector2Add = lib.Vector2Add,
Vector2AddValue = lib.Vector2AddValue,
Vector2Angle = lib.Vector2Angle,
Vector2Clamp = lib.Vector2Clamp,
Vector2ClampValue = lib.Vector2ClampValue,
Vector2Distance = lib.Vector2Distance,
Vector2DistanceSqr = lib.Vector2DistanceSqr,
Vector2Divide = lib.Vector2Divide,
Vector2DotProduct = lib.Vector2DotProduct,
Vector2Equals = lib.Vector2Equals,
Vector2Invert = lib.Vector2Invert,
Vector2Length = lib.Vector2Length,
Vector2LengthSqr = lib.Vector2LengthSqr,
Vector2Lerp = lib.Vector2Lerp,
Vector2LineAngle = lib.Vector2LineAngle,
Vector2Max = lib.Vector2Max,
Vector2Min = lib.Vector2Min,
Vector2MoveTowards = lib.Vector2MoveTowards,
Vector2Multiply = lib.Vector2Multiply,
Vector2Negate = lib.Vector2Negate,
Vector2Normalize = lib.Vector2Normalize,
Vector2One = lib.Vector2One,
Vector2Reflect = lib.Vector2Reflect,
Vector2Refract = lib.Vector2Refract,
Vector2Rotate = lib.Vector2Rotate,
Vector2Scale = lib.Vector2Scale,
Vector2Subtract = lib.Vector2Subtract,
Vector2SubtractValue = lib.Vector2SubtractValue,
Vector2Transform = lib.Vector2Transform,
Vector2Zero = lib.Vector2Zero,
Vector3Add = lib.Vector3Add,
Vector3AddValue = lib.Vector3AddValue,
Vector3Angle = lib.Vector3Angle,
Vector3Barycenter = lib.Vector3Barycenter,
Vector3Clamp = lib.Vector3Clamp,
Vector3ClampValue = lib.Vector3ClampValue,
Vector3CrossProduct = lib.Vector3CrossProduct,
Vector3CubicHermite = lib.Vector3CubicHermite,
Vector3Distance = lib.Vector3Distance,
Vector3DistanceSqr = lib.Vector3DistanceSqr,
Vector3Divide = lib.Vector3Divide,
Vector3DotProduct = lib.Vector3DotProduct,
Vector3Equals = lib.Vector3Equals,
Vector3Invert = lib.Vector3Invert,
Vector3Length = lib.Vector3Length,
Vector3LengthSqr = lib.Vector3LengthSqr,
Vector3Lerp = lib.Vector3Lerp,
Vector3Max = lib.Vector3Max,
Vector3Min = lib.Vector3Min,
Vector3MoveTowards = lib.Vector3MoveTowards,
Vector3Multiply = lib.Vector3Multiply,
Vector3Negate = lib.Vector3Negate,
Vector3Normalize = lib.Vector3Normalize,
Vector3One = lib.Vector3One,
Vector3OrthoNormalize = lib.Vector3OrthoNormalize,
Vector3Perpendicular = lib.Vector3Perpendicular,
Vector3Project = lib.Vector3Project,
Vector3Reflect = lib.Vector3Reflect,
Vector3Refract = lib.Vector3Refract,
Vector3Reject = lib.Vector3Reject,
Vector3RotateByAxisAngle = lib.Vector3RotateByAxisAngle,
Vector3RotateByQuaternion = lib.Vector3RotateByQuaternion,
Vector3Scale = lib.Vector3Scale,
Vector3Subtract = lib.Vector3Subtract,
Vector3SubtractValue = lib.Vector3SubtractValue,
Vector3ToFloatV = lib.Vector3ToFloatV,
Vector3Transform = lib.Vector3Transform,
Vector3Unproject = lib.Vector3Unproject,
Vector3Zero = lib.Vector3Zero,
Vector4Add = lib.Vector4Add,
Vector4AddValue = lib.Vector4AddValue,
Vector4Distance = lib.Vector4Distance,
Vector4DistanceSqr = lib.Vector4DistanceSqr,
Vector4Divide = lib.Vector4Divide,
Vector4DotProduct = lib.Vector4DotProduct,
Vector4Equals = lib.Vector4Equals,
Vector4Invert = lib.Vector4Invert,
Vector4Length = lib.Vector4Length,
Vector4LengthSqr = lib.Vector4LengthSqr,
Vector4Lerp = lib.Vector4Lerp,
Vector4Max = lib.Vector4Max,
Vector4Min = lib.Vector4Min,
Vector4MoveTowards = lib.Vector4MoveTowards,
Vector4Multiply = lib.Vector4Multiply,
Vector4Negate = lib.Vector4Negate,
Vector4Normalize = lib.Vector4Normalize,
Vector4One = lib.Vector4One,
Vector4Scale = lib.Vector4Scale,
Vector4Subtract = lib.Vector4Subtract,
Vector4SubtractValue = lib.Vector4SubtractValue,
Vector4Zero = lib.Vector4Zero,
Vox_FreeArrays = lib.Vox_FreeArrays,
Vox_GetVoxel = lib.Vox_GetVoxel,
Vox_LoadFromMemory = lib.Vox_LoadFromMemory,
WaitTime = lib.WaitTime,
WaveCopy = lib.WaveCopy,
WaveCrop = lib.WaveCrop,
WaveFormat = lib.WaveFormat,
WindowContentScaleCallback = lib.WindowContentScaleCallback,
WindowDropCallback = lib.WindowDropCallback,
WindowFocusCallback = lib.WindowFocusCallback,
WindowIconifyCallback = lib.WindowIconifyCallback,
WindowMaximizeCallback = lib.WindowMaximizeCallback,
WindowPosCallback = lib.WindowPosCallback,
WindowShouldClose = lib.WindowShouldClose,
WindowSizeCallback = lib.WindowSizeCallback,
Wrap = lib.Wrap,
acquireMonitorX11 = lib.acquireMonitorX11,
bit_reverse = lib.bit_reverse,
captureCursor = lib.captureCursor,
chooseEGLConfig = lib.chooseEGLConfig,
chooseGLXFBConfig = lib.chooseGLXFBConfig,
closeJoystick = lib.closeJoystick,
codebook_decode_deinterleave_repeat = lib.codebook_decode_deinterleave_repeat,
codebook_decode_scalar_raw = lib.codebook_decode_scalar_raw,
codebook_decode_start = lib.codebook_decode_start,
compareJoysticks = lib.compareJoysticks,
compareVideoModes = lib.compareVideoModes,
convertLatin1toUTF8 = lib.convertLatin1toUTF8,
convert_channels_short_interleaved = lib.convert_channels_short_interleaved,
convert_samples_short = lib.convert_samples_short,
createHiddenCursor = lib.createHiddenCursor,
createKeyTablesX11 = lib.createKeyTablesX11,
decode_residue = lib.decode_residue,
defaultAllocate = lib.defaultAllocate,
defaultDeallocate = lib.defaultDeallocate,
defaultReallocate = lib.defaultReallocate,
deregister_tm_clones = lib.deregister_tm_clones,
destroyContextEGL = lib.destroyContextEGL,
destroyContextGLX = lib.destroyContextGLX,
destroyContextOSMesa = lib.destroyContextOSMesa,
disableRawMouseMotion = lib.disableRawMouseMotion,
drmp3d_DCT_II = lib.drmp3d_DCT_II,
drmp3d_synth_granule = lib.drmp3d_synth_granule,
drmp3d_synth_pair = lib.drmp3d_synth_pair,
drmp3dec_decode_frame = lib.drmp3dec_decode_frame,
drmp3dec_f32_to_s16 = lib.drmp3dec_f32_to_s16,
drmp3dec_init = lib.drmp3dec_init,
dynamic_fgets = lib.dynamic_fgets,
enableCursor = lib.enableCursor,
enableRawMouseMotion = lib.enableRawMouseMotion,
errorHandler = lib.errorHandler,
extensionSupportedEGL = lib.extensionSupportedEGL,
extensionSupportedGLX = lib.extensionSupportedGLX,
extensionSupportedOSMesa = lib.extensionSupportedOSMesa,
extrapolate2 = lib.extrapolate2,
findMapping = lib.findMapping,
findValidMapping = lib.findValidMapping,
float32_unpack = lib.float32_unpack,
flush_packet = lib.flush_packet,
frame_dummy = lib.frame_dummy,
get32 = lib.get32,
get32_packet = lib.get32_packet,
get8 = lib.get8,
get8_packet = lib.get8_packet,
get8_packet_raw = lib.get8_packet_raw,
getAtomIfSupported = lib.getAtomIfSupported,
getEGLConfigAttrib = lib.getEGLConfigAttrib,
getEGLErrorString = lib.getEGLErrorString,
getGLXFBConfigAttrib = lib.getGLXFBConfigAttrib,
getModeInfo = lib.getModeInfo,
getProcAddressEGL = lib.getProcAddressEGL,
getProcAddressGLX = lib.getProcAddressGLX,
getProcAddressOSMesa = lib.getProcAddressOSMesa,
getSelectionString = lib.getSelectionString,
getWindowState = lib.getWindowState,
get_bits = lib.get_bits,
get_seek_page_info = lib.get_seek_page_info,
getn = lib.getn,
gladLoadGL = lib.gladLoadGL,
gladLoadGLUserPtr = lib.gladLoadGLUserPtr,
handleAbsEvent = lib.handleAbsEvent,
handleSelectionRequest = lib.handleSelectionRequest,
hash_djb2 = lib.hash_djb2,
hash_table_find = lib.hash_table_find,
hash_table_insert_value = lib.hash_table_insert_value,
ilog = lib.ilog,
imdct_step3_inner_r_loop = lib.imdct_step3_inner_r_loop,
imdct_step3_iter0_loop = lib.imdct_step3_iter0_loop,
include_in_sort = lib.include_in_sort,
initJoysticks = lib.initJoysticks,
init_blocksize = lib.init_blocksize,
inputContextDestroyCallback = lib.inputContextDestroyCallback,
inputMethodDestroyCallback = lib.inputMethodDestroyCallback,
inputMethodInstantiateCallback = lib.inputMethodInstantiateCallback,
insertArrayColor = lib.insertArrayColor,
insertArrayUShort = lib.insertArrayUShort,
insertArrayVector3 = lib.insertArrayVector3,
inverse_mdct = lib.inverse_mdct,
isFrameExtentsEvent = lib.isFrameExtentsEvent,
isSelPropNewValueNotify = lib.isSelPropNewValueNotify,
isSelectionEvent = lib.isSelectionEvent,
isValidElementForJoystick = lib.isValidElementForJoystick,
is_line_ending = lib.is_line_ending,
is_whole_packet_present = lib.is_whole_packet_present,
jsmn_alloc_token = lib.jsmn_alloc_token,
jsmn_parse = lib.jsmn_parse,
length_until_newline = lib.length_until_newline,
m3d_frame = lib.m3d_frame,
m3d_free = lib.m3d_free,
m3d_freehook = lib.m3d_freehook,
m3d_load = lib.m3d_load,
m3d_loaderhook = lib.m3d_loaderhook,
m3d_pose = lib.m3d_pose,
makeContextCurrentEGL = lib.makeContextCurrentEGL,
makeContextCurrentGLX = lib.makeContextCurrentGLX,
makeContextCurrentOSMesa = lib.makeContextCurrentOSMesa,
maybe_start_packet = lib.maybe_start_packet,
memclear = lib.memclear,
memcopy = lib.memcopy,
memcpy_pad = lib.memcpy_pad,
msf_free_gif_state = lib.msf_free_gif_state,
msf_gif_begin = lib.msf_gif_begin,
msf_gif_begin_to_file = lib.msf_gif_begin_to_file,
msf_gif_end = lib.msf_gif_end,
msf_gif_end_to_file = lib.msf_gif_end_to_file,
msf_gif_frame = lib.msf_gif_frame,
msf_gif_frame_to_file = lib.msf_gif_frame_to_file,
msf_gif_free = lib.msf_gif_free,
my_atoi = lib.my_atoi,
my_strdup = lib.my_strdup,
my_strndup = lib.my_strndup,
next_segment = lib.next_segment,
openJoystickDevice = lib.openJoystickDevice,
parseFloat = lib.parseFloat,
parseFloat3 = lib.parseFloat3,
parseLine = lib.parseLine,
parseMapping = lib.parseMapping,
point_compare = lib.point_compare,
pollAbsState = lib.pollAbsState,
qoa_decode = lib.qoa_decode,
qoa_decode_frame = lib.qoa_decode_frame,
qoa_decode_header = lib.qoa_decode_header,
qoa_encode = lib.qoa_encode,
qoa_encode_frame = lib.qoa_encode_frame,
qoa_encode_header = lib.qoa_encode_header,
qoa_max_frame_size = lib.qoa_max_frame_size,
qoa_read = lib.qoa_read,
qoa_write = lib.qoa_write,
qoaplay_close = lib.qoaplay_close,
qoaplay_decode = lib.qoaplay_decode,
qoaplay_decode_frame = lib.qoaplay_decode_frame,
qoaplay_get_duration = lib.qoaplay_get_duration,
qoaplay_get_frame = lib.qoaplay_get_frame,
qoaplay_get_time = lib.qoaplay_get_time,
qoaplay_open = lib.qoaplay_open,
qoaplay_open_memory = lib.qoaplay_open_memory,
qoaplay_rewind = lib.qoaplay_rewind,
qoaplay_seek_frame = lib.qoaplay_seek_frame,
rect_height_compare = lib.rect_height_compare,
rect_original_order = lib.rect_original_order,
refreshVideoModes = lib.refreshVideoModes,
register_tm_clones = lib.register_tm_clones,
releaseCursor = lib.releaseCursor,
releaseMonitorX11 = lib.releaseMonitorX11,
resample_row_1 = lib.resample_row_1,
rgVector2Distance = lib.rgVector2Distance,
rprand_get_value = lib.rprand_get_value,
rprand_load_sequence = lib.rprand_load_sequence,
rprand_set_seed = lib.rprand_set_seed,
rprand_splitmix64 = lib.rprand_splitmix64,
rprand_unload_sequence = lib.rprand_unload_sequence,
rprand_xoshiro = lib.rprand_xoshiro,
sdefl_bound = lib.sdefl_bound,
sdefl_compr = lib.sdefl_compr,
sdefl_flush = lib.sdefl_flush,
sdefl_fnd = lib.sdefl_fnd,
sdefl_heap_sub = lib.sdefl_heap_sub,
sdefl_huff = lib.sdefl_huff,
sdefl_match_codes = lib.sdefl_match_codes,
sdefl_put = lib.sdefl_put,
sdefl_seq = lib.sdefl_seq,
sdefl_sort_sym = lib.sdefl_sort_sym,
sdeflate = lib.sdeflate,
sendEventToWM = lib.sendEventToWM,
set_file_offset = lib.set_file_offset,
setup_free = lib.setup_free,
setup_malloc = lib.setup_malloc,
setup_temp_free = lib.setup_temp_free,
setup_temp_malloc = lib.setup_temp_malloc,
sinfl__get = lib.sinfl__get,
sinfl_build = lib.sinfl_build,
sinfl_copy64 = lib.sinfl_copy64,
sinfl_decode = lib.sinfl_decode,
sinfl_decompress = lib.sinfl_decompress,
sinfl_refill = lib.sinfl_refill,
sinflate = lib.sinflate,
skip = lib.skip,
skip_space = lib.skip_space,
start_decoder = lib.start_decoder,
start_packet = lib.start_packet,
start_page = lib.start_page,
start_page_no_capturepattern = lib.start_page_no_capturepattern,
swapBuffersEGL = lib.swapBuffersEGL,
swapBuffersGLX = lib.swapBuffersGLX,
swapBuffersOSMesa = lib.swapBuffersOSMesa,
swapIntervalEGL = lib.swapIntervalEGL,
swapIntervalGLX = lib.swapIntervalGLX,
swapIntervalOSMesa = lib.swapIntervalOSMesa,
terminate = lib.terminate,
tinyobj_attrib_free = lib.tinyobj_attrib_free,
tinyobj_attrib_init = lib.tinyobj_attrib_init,
tinyobj_material_add = lib.tinyobj_material_add,
tinyobj_materials_free = lib.tinyobj_materials_free,
tinyobj_parse_and_index_mtl_file = lib.tinyobj_parse_and_index_mtl_file,
tinyobj_parse_mtl_file = lib.tinyobj_parse_mtl_file,
tinyobj_parse_obj = lib.tinyobj_parse_obj,
tinyobj_shapes_free = lib.tinyobj_shapes_free,
translateState = lib.translateState,
ttULONG = lib.ttULONG,
uint32_compare = lib.uint32_compare,
until_space = lib.until_space,
updateCursorImage = lib.updateCursorImage,
updateNormalHints = lib.updateNormalHints,
updateWindowMode = lib.updateWindowMode,
vidmodeFromModeInfo = lib.vidmodeFromModeInfo,
vorbis_decode_initial = lib.vorbis_decode_initial,
vorbis_decode_packet = lib.vorbis_decode_packet,
vorbis_decode_packet_rest = lib.vorbis_decode_packet_rest,
vorbis_deinit = lib.vorbis_deinit,
vorbis_find_page = lib.vorbis_find_page,
vorbis_finish_frame = lib.vorbis_finish_frame,
vorbis_init = lib.vorbis_init,
vorbis_pump_first_frame = lib.vorbis_pump_first_frame,
waitForAnyEvent = lib.waitForAnyEvent,
waitForVisibilityNotify = lib.waitForVisibilityNotify,
waitForX11Event = lib.waitForX11Event,
zsdeflate = lib.zsdeflate,
zsinflate = lib.zsinflate,
